 | | | | | | | | | | | | | | 
 |S| |S| |S| |S| |S| |S| |S| 
 | | | | | | | | | | | | | | 
 |S| |S| |S| |S| |S| |S| |S| 
 | | | | | | | | | | | | | | 
 |S| |S| |S| | | |S| |S| |S| 
 | | | | | | | | | | | | | | 
 |S| |S| |S| | | |S| |S| |S| 
 | | | | | | | | | | | | | | 
 |S| |S| |S| |S| |S| |S| |S| 
 | | | | | | | | | | | | | | 
 |S| |S| |S| |S| |S| |S| |S| 
X| | | | | | | | | | | | | |Y