 | | | | | | | | | | | | | | 
 |S|B|S|B|S| |S| |S|B|S|B|S| 
 |B| | | |B| |B| |B| | | |B| 
 |S| | | |S| |S| |S| | | |S| 
 |B| | | |B| |B| |B| | | |B| 
 |S|B|S|B|S| |S| |S|B|S|B|S| 
 | | | | | | | | | | | | | | 
 |S|B|S| |S|B|S|B|S| |S|B|S| 
 | | | | |B| | | |B| | | | | 
B|S|B|S| |S| | | |S| |S|B|S|B
 | |X|B| |B| | | |B| |B|Y| | 
 |S| |S| |S|B|S|B|S| |S| |S| 
 | | |B| | | | | | | |B| | | 