5| | | | |B| | | |B| | | | |5
 |S| |S| |S| |S| |S| |S| |S| 
 | | | | |B| | | |B| | | | | 
 |S| |S| |S|B|S|B|S| |S| |S| 
1| | | | |3| |3| |3| | | | |1
S|S|S|S|S|S|S|S|S|S|S|S|S|S|S
S|X| | | | | | | | | | | |Y|S
S|S|S|S|S|S|S|S|S|S|S|S|S|S|S
1| | | | |3| |3| |3| | | | |1
 |S| |S| |S|B|S|B|S| |S| |S| 
 | | | | |B| | | |B| | | | | 
 |S| |S| |S| |S| |S| |S| |S| 
5| | | | |B| | | |B| | | | |5