 | | | | |B| | | |B| | | | | 
 |S| |S| |S| |S| |S| |S| |S| 
 | | | | |B| | | |B| | | | | 
 |S| |S| |S|B|S|B|S| |S| |S| 
 | | | | | | | | | | | | | | 
S|S|S|S|S|S|S|S|S|S|S|S|S|S|S
S|X| | | | | | | | | | | |Y|S
S|S|S|S|S|S|S|S|S|S|S|S|S|S|S
 | | | | | | | | | | | | | | 
 |S| |S| |S|B|S|B|S| |S| |S| 
 | | | | |B| | | |B| | | | | 
 |S| |S| |S| |S| |S| |S| |S| 
 | | | | |B| | | |B| | | | | 