 | | | | | | | | | | | | | | 
 |S|B|S|B|S| | | |S|B|S|B|S| 
 |B| | | | | | | | | | | |B| 
 |S| |S| |S| | | |S|B|S| |S| 
 |B| | | | | | | | | | | |B| 
 | | | |S|S|S|S|S|S|S| | | | 
 | | | |S|X| | | |Y|S| | | | 
 | | | |S|S|S|S|S|S|S| | | | 
 |B| | | | | | | | | | | |B| 
 |S|B|S|B|S|B|S|B|S|B|S|B|S| 
 |B| | | | | | | | | | | |B| 
 |S|B|S|B|S|B|S|B|S|B|S|B|S| 
 | | | | | | | | | | | | | | 