 | | | | | | | | | | | | | | 
 |S|B|S|B|S|H| | |S|B|S|B|S| 
 |B| | | | | | | | | | | |B| 
 |S| |S| |S| | | |S|B|S| |S| 
 |B| | | | | | | | | | | |B| 
 |H| | |S|S|S|S|S|S|S|H| | | 
 | | | |S|X| |T| |Y|S| | | | 
 | | | |S|S|S|S|S|S|S| | | | 
 |B| | | | | | | | | | | |B| 
 |S|B|S|B|S|B|S|B|S|B|S|B|S| 
 |B|T| | | | | | | | | |T|B| 
 |S|B|S|B|S|B|S|B|S|B|S|B|S| 
 | | | | | | | | | | | | | | 