 | | | | | |H| | | | | | | | 
 |S|S|S| |S| | | |S| |S|S|S| 
 |B|T|S| | | | | | | |S|3|B| 
 |S| |S| |S|H| | |S| |S|3|S| 
 |B| |S| | | | | | | |S|3|B| 
 |S| |S| |S| | | |S| |S|3|S| 
X|B|3|S| | | | | | | |S|3|B|Y
 |S|3|S| |S|H| | |S| |S| |S| 
 |B|3|S| | | | | | | |S| |B| 
 |S|3|S| |S| | | |S| |S| |S| 
 |B|3|S| | |H| | | | |S|T|B| 
 |S|S|S| |S| | | |S| |S|S|S| 
 | | | | | | | | | | | | | | 