 | | | | | | | | | | | | | | 
 |S|S|S| |S| | | |S| |S|S|S| 
 |B| |S| | | | | | | |S| |B| 
 |S| |S| |S| | | |S| |S| |S| 
 |B| |S| | | | | | | |S| |B| 
 |S| |S| |S| | | |S| |S| |S| 
X|B| |S| | | | | | | |S| |B|Y
 |S| |S| |S| | | |S| |S| |S| 
 |B| |S| | | | | | | |S| |B| 
 |S| |S| |S| | | |S| |S| |S| 
 |B| |S| | | | | | | |S| |B| 
 |S|S|S| |S| | | |S| |S|S|S| 
 | | | | | | | | | | | | | | 