 | | | | | | | | | | | | | | 
 |S|S|S| |S| | | |S| |S|S|S| 
 |B| |S| | | | | | | |S|3|B| 
 |S| |S| |S| | | |S| |S|3|S| 
 |B| |S| | | | | | | |S|3|B| 
 |S| |S| |S| | | |S| |S|3|S| 
X|B|3|S| | | | | | | |S|3|B|Y
 |S|3|S| |S| | | |S| |S| |S| 
 |B|3|S| | | | | | | |S| |B| 
 |S|3|S| |S| | | |S| |S| |S| 
 |B|3|S| | | | | | | |S| |B| 
 |S|S|S| |S| | | |S| |S|S|S| 
 | | | | | | | | | | | | | | 