C|B| | | | | |X| | | | | |B|C
B|S|B|B|B|B|B|B|B|B|B|B|B|S|B
 | | | | | | | | | | | | | | 
 | | | | | | | | | | | | | | 
 | | | | |H| | | | | | | | | 
 | | | | | | | | | | | | | | 
 | | | | | | | | | | | | | | 
 | | | | | | | | | | | | | | 
 | | | | | | | | | | | | | | 
 | | | | | | | | | | | | | | 
 | | | | | | | | | | | | | | 
B|S|B|B|B|B|B|B|B|B|B|B|B|S|B
C|B| | | | | |Y| | | | | |B|C