 |B| | | | | |X| | | | | |B| 
B|S|B|B|B|B|B|B|B|B|B|B|B|S|B
 | | | | | | | | | | | | | | 
 | | | | | | | | | | | | | | 
 | | | | | | | | | | | | | | 
 | | | | | | | | | | | | | | 
 | | | | | | | | | | | | | | 
 | | | | | | | | | | | | | | 
 | | | | | | | | | | | | | | 
 | | | | | | | | | | | | | | 
 | | | | | | | | | | | | | | 
B|S|B|B|B|B|B|B|B|B|B|B|B|S|B
 |B| | | | | |Y| | | | | |B| 